1,1,1,1,1,1,1,1,1,1,1,1,1
1,0,0,k,k,k,k,k,k,0,0,1,1
1,0,0,0,0,1,1,0,0,0,0,2,1
1,0,0,0,0,0,0,0,0,0,0,1,1
1,0,0,1,0,1,1,0,1,0,0,1,1
1,0,0,0,0,0,0,0,0,0,0,1,1
1,0,0,1,0,1,1,0,1,0,0,1,1
1,0,0,0,0,0,0,0,0,0,0,1,1
1,0,0,1,0,1,1,0,1,0,0,1,1
1,0,0,0,0,0,0,0,0,0,0,B,1
1,0,0,0,0,0,0,0,0,0,0,1,1
1,1,1,1,1,1,1,1,1,1,1,1,1
