1,1,1,1,1,1,1,1,1,1
1,1,1,0,0,0,1,1,1,1
1,0,0,0,0,0,0,0,0,1
1,0,0,1,1,1,0,0,1,1
1,0,0,1,1,1,0,0,1,1
1,0,0,d,d,d,0,0,0,1
1,0,0,0,0,0,0,0,0,1
1,1,L,1,1,1,1,R,1,1
1,1,1,1,1,1,1,1,1,1